1T111111111111111111111111T11111111111111T11111111
10000000100000000001000000000000010001000010000000
10000000100000000001000000000000010001000010000000
10000000100000000001000000000000010001000010000000
100000001000000000010000000000000T0001000010000000
1111T1111111111T1111000000000000010001000010000000
10000000100000000001000000000000010001000010000000
100000001000000000010000000000000100010000T0000000
10000000100000000001000000000000010001000010000000
111111111T111111111111111111111T111111111111111111
10000000100001000001000000000100010001000010000000
10000000100001000001000000000100010001000010000000
1000000011111111111111111111111111000T000010000000
10000000100001000001000000000100010001000010000000
T0000000100001000001000000000100010001000010000000
1000000010000T000001000000000100010001000011111111
10000000100001000001000000000100010001000010000000
10000000100001000001000000000100010001000010000000
10000000100001000001000000000100010001000010000000
10000000100001000001000000000100010001000010000000
10000000100001000001000000000100010001000010000000
1111T11111T11111111111T11111111111111111111111111T
100000001001000A0001000000000000010000000010000100
10000000100100000001000000000000010000000010000100
10000000100100000001000000000000011111111T10000T00
10000000100100000001000000000000010000000010000100
10000000100100000001000000000000010000000010000100
1111111T11111T1111111111T1111111110000000010000100
10000000100100000001000000000000010000000010000100
10000000100100000001000000000000010000000010000100
100000001001000000010000000000000100000000T0000100
10000000100100000001000000000000010000000010000100
10000000100100000001000000000000010000000010000100
10000000100100000001000000000000010000000010000100
1111111111T111111111111111111111111111111111111111
10000000100000000001000010000000010000000010000000
100000001000000000010000T00000000T0000000010000000
10000000100000000001000010000000010000000010000000
10000000100000000001000010000000010000000010000000
10000000100000000001111111111111111111111T11111111
10000000T00000000001000010000000010000000010000000
10000000100000000001000010000000010000000010000000
10000000100000000001000010000000010000000011111T11
100000001000000000010000100000000100000000T0000000
10000000100000000001000010000000010000000010000000
100000001111111T111111111111T111110000000010000000
10000000100000000001000010000000010000000010000000
10000000100000000001000010000000010000000010000000
100000001000000000010000100000000T0000000010000000
1111T11111111111111111T111111111111111111111111111
